6	9	6	4	1	8	6	6
5	8	7	2	3	6	2	4
3	4	3	G	4	9	2	5
1	1	9	1	9	S	7	5
8	8	1	5	2	3	1	3
6	2	2	6	4	9	2	7
9	4	7	8	1	4	5	7
