7	8	8	6	6	2	3	5	9	7	8
3	5	1	3	5	S	9	2	1	2	8
9	6	5	3	3	4	1	2	6	7	4
6	9	G	5	4	7	3	6	6	9	6
1	2	2	9	9	1	3	9	3	7	5
8	7	3	5	2	9	7	8	7	4	2
